Wings + Horns -> Reigning Champ,Adidas,Danner,Dayton,New Balance,Norse Projects,Our Legacy,Robert Geller,John Elliot,White Mountaneering
Howlin -> Our Legacy,Acne,Inis Meain,Inverallan,SNS Herning,Beams,Barbour,Thom Browne
Ralph Lauren -> J Crew,Club Monaco,Hackett,Fred Perry,Gant,Lacoste,Raf Simons,Moncler,Hackett,Hugo Boss
Filson -> L L Bean,Pendleton,Woolrich,Barbour,Red Wing,Tellason,Danner Tanner Goods,Orvis,Alden,Gitman Bros,Frost River,LVC,W H Ranch,Rising Sun MFG
Norse Projects -> APC,COS,Acne,Our Legacy,Wood Wood,Filippa K,Bruuns Bazaar,Libertine Libertine,Hans Kjobenhavn
Taylor Stitch -> Peter Manning,Pistol Lake,Everlane,Alex Mill
H&M -> Uniqlo,Forever 21,COS
Banana Republic -> Lands End,J Crew,Club Monaco,Bonobos
Engineered Garments -> Orslow,Needles,Hold Fast, ts(s),Lowloom,Kapital,Nigel Cabourn,Visvim,RRL,Bleu de Paname,Post overalls,Apolis,Tender,Arpenteur
Apolis -> Nigel Cabourn,Engineered Garments,Orlebar Brown,Thom Browne,Gustin,Steven Alan,Filson,Muji
Rag&Bone -> Vince
The Viridi-anne -> Rick Owens,Damir Doma,Ann Demeulemeester,Knomadik,Comme Des Garcons,Yohji,OAK NYC,Individual Sentiments,MA+,Julius,Label Under Construction,Theory,Alexandre Plokhov,Helmut Lang,KKA,Forme D'Expression,Boris Bidjan Saberi,Andrea Ya'aqov,Nicolas Andreas Taralis,Masnada,Lost & Found,Lumen Et Umbra,Tuesday Night Band Practice,Devoa,Taichi Murakami,Avant Toi,Stone Island,Casey Casey,08sircus,Carol Christian Poell,Void The Brand,Clothsurgeon,Song For The Mute,Ovate,You're A Champion
Saint Laurent -> Sandro,Story Et Fall,Lad Musician,Trash,Vaudeville,Straight To Hell,Tripp NYC,Underground Shoes,The Kooples,All Saints,Zadig et Voltaire
Dana Lee -> Orslow,Universal Product,Engineered Garments,Story MFG
Acronym -> Isaora,Nike ACG,Arc'teryx,Veilance,Stone Island,Nanamica,WTAPS,Eyes And Sins,Nike ACG,Disaeran,Isness,Gyakusou,Rip Van Winkle
Charles Tyrwhitt -> Hawes And Curtis,Thomas Pink,TM Lewin
Zanerobe -> Iloveugly,Publish,Elwood,Bassike
Sandro -> IRO Paris,COS,Saint Laurent,The Kooples
Gap -> Uniqlo,Everlane,J Crew,APC
Patagonia -> Penfield,Cotopaxi,REI,The North Face,Mountain Hardware,White Mountaineering,Arc'teryx,Veilance
Tom Ford -> Thom Browne,Rubinacci,Huntsman,Sunspel,Brioni,Katon,HermÃ¨s,Ambrosi Napoli,Loro Piana,Attolini
Our Legacy -> A Kind Of Guise,Acne,BLK DNM,APC,Whyred,Filippa K,Hope Sthlm, A O CMS,Tres Bien
Carhartt WIP -> Neighborhood,WTAPS,Beams+,Dickies,Duluth Trading,5.11
Cav Empt -> Eyes & Sins,Brain Dead,Profound Aesthetic
Reigning Champ -> Muttonhead,Real McCoys,Strike Gold,Buzz Rickson,Wings + Horns,Naked + Famous,Minimum,Pistol Lake
Aldo -> ASOS,Call It Spring,Little Burgundy,Globo
Brooks Brothers -> Ralph Lauren,Vineyard Vines,Nautica,Calvin Klein
InAisce -> Julius,Comme Des Garcons,Yohji
Schott NYC -> Golden Bear
Cheap Monday -> Weekday,Samsoe Samsoe,Minimum,Norse Projects,Acne
Todd Snyder -> Billy Reid,Thom Browne,The Real McCoy
kent Wang -> Howard Yount,Vanda Fine Clothing,Panta Clothing,Finealta,Berg&Berg,SuitSupply,Tagliatore,Lubiam,LBM,Aspesi
Lands End -> Beams +
Gustin -> Common Projects,Engineered Garments,Alden,Naked and Famous,Unbranded,Rogue Territory
All Saints -> April 77
Farah -> Ben Sherman,Fred Perry
Undercoverism -> Blackmeans,Lad Musician,Number (N)ine,Nonnative, Cav Empt,TheSoloist
JNCO -> Freshjive,Lee Pipes
Wal-mart -> Target,Kmart
Supreme -> Only NY,Raised By Wolves,Palace,FuckingAwesome
Palace -> Keep NY everywhere,M.o.o.d,Bronze56k,DimeMTL,Gosha Rubchinskiy
COS -> Norse Projects,Everlane,Acne,samsoe samsoe,won hundred,whyred,APC,Acne,Our Legacy,Jil Sander
Julius -> Zam Barett, Carol Christian Poell e,Carpe Dieme
Ronnie Feig -> John Elliot + Co
Acne Studios -> APC,BLK DNM,Our Legacy,Whyred,Filippa K,Hope Sthlm,a.o.cms,Tres Bien
darn tough -> Fox River
RRL -> scotch and soda,moncler,club monaco
Jack & Jones -> SuperDry,Fear of God
WTAPS -> NBHD,Sophnet,Supreme,Bape,FPAR,Visvim
Original Penguin -> Polo Ralph Lauren, Lacoste, Fred Perry, Ben Sherman
Carhartt -> Dickies, Duluth Trading Co, 5.11 Tactical,Iron Heart
Rogue Territory -> 3sixteen, Epaulet, Naked & Famous
Bonobos -> club monaco
Tom Ford -> gucci
Pistol Lake -> Reigning Champ, Wings and Horns, Champion
Jack Wills -> Hollister, Sunspel, Abercrombie
